Furkan	Yardimci
Mehdi	Serifoglu
Polat	Seyfi
Alper	Orhan
Aylin	Sevkin
Bahar	Yardimci
Bedia	Findik
Bedriye	Esgin
Behin	Esgin
Buket	Serifoglu
Caner	Deliloglu
Hazar	Esgin
Ozan	Dincturk
Ceyhun	Tezmen
Demircan	Ciddi
Dilay	Esgin
Doktora	Ocar
Cem	Orhan
Ecem	Zagli
Edis	Tezmen
Efecan	Tezmen
Eser	Sevkin
Esim	Zaptiye
Fahir	Sevcan
Feray	Yardimci
Ferdacan	Cansu
Fethullah	Findik
Sena	Yardimci
Hatice	Serifoglu
Gamze	Zaptiye
Gelincik	Sevkin
Gediz	Ciddi
Halim	Findik
Haluk	Serifoglu
Hasan	Tezmen
Hatice	Sevkin
Hulki	Serifoglu
Ilgaz	Yardimci
Irmak	Orhan
Iraz	Tanrikulu
Jiyan	Tezmen
Kemal	Findik
Kerime	Zagli
Kubat	Findik
Kubilay	Tanrikulu
Kerim	Yardimci
Latife	Sevkin
Lale	Egin
Lerzan	Ciddi
Latif	Dincturk
Mehmet	Dincturk
Mihrinaz	Cansu
Muhammed	Tanrikulu
Mustafa	Fatin
Nugaye	Findik
Numan	Orhan
Nurfer	Sevcan
Nedim	Serifoglu
Naci	Deliloglu
Okbay	Sevkin
Oktay	Zaptiye
Osman	Esgin
Okan	Findik
Paker	Ciddi
Paksoy	Zaptiye
Perker	Ocar
Pertev	Seyfi
Raif	Tezmen
Ramazan	Dincturk
Rana	Yolcu
Rima	Yardimci
Sabiha	Tezmen
Samet	Serifoglu
Selcen	Sevkin
Sena	Deliloglu
Serra	Tezmen
Talya	Dincturk
Taylan	Egin
Tayyip	Sevkin
Tunahan	Deliloglu
Ugur	Zaptiye
Uras	Yardimci
Uzel	Deliloglu
Vahide	Serifoglu
Vedia	Yolcu
Velit	Fatin
Yaprak	Zagli
Yasemin	Deliloglu
Yasemin	Tezmen
Yakup	Esgin
Yeliz	Zagli
Zeynep	Zaptiye
Zeynep	Ciddi
Zeynep	Ciddi
Zahide	Serifoglu
Cafer	Sevcan
Can	Deliloglu
Atahan	Fatin
Canberk	Ocar
Candan	Dincturk